HDj	/projects/ucar-lab/Siddhartha/Covid_19/snATACseq/MultiOme/MultiomeRuns/Run_1/outs/atac_peaks.bed	/projects/ucar-lab/Siddhartha/Covid_19/snATACseq/MultiOme/MultiomeRuns/Run_1/outs/SplitBams_Final/AllBarcodes_OutliersandDoubletRemovedTwice.csv	/projects/ucar-lab/Siddhartha/Covid_19/snATACseq/MultiOme/MultiomeRuns/Run_1/outs/SplitBams_Final/Plots/atac_fragments.tsv.gz
jcov92	/projects/ucar-lab/Siddhartha/Covid_19/snATACseq/MultiOme/MultiomeRuns/Run_2/outs/atac_peaks.bed	/projects/ucar-lab/Siddhartha/Covid_19/snATACseq/MultiOme/MultiomeRuns/Run_2/outs/SplitBams_Final/AllBarcodes_OutliersandDoubletRemovedTwice.csv	/projects/ucar-lab/Siddhartha/Covid_19/snATACseq/MultiOme/MultiomeRuns/Run_2/outs/SplitBams_Final/Plots/atac_fragments.tsv.gz
HDa	/projects/ucar-lab/Siddhartha/Covid_19/snATACseq/MultiOme/MultiomeRuns/Run_3/outs/atac_peaks.bed	/projects/ucar-lab/Siddhartha/Covid_19/snATACseq/MultiOme/MultiomeRuns/Run_3/outs/SplitBams_Final/AllBarcodes_OutliersandDoubletRemovedTwice.csv	/projects/ucar-lab/Siddhartha/Covid_19/snATACseq/MultiOme/MultiomeRuns/Run_3/outs/SplitBams_Final/Plots/atac_fragments.tsv.gz
jcov52	/projects/ucar-lab/Siddhartha/Covid_19/snATACseq/MultiOme/MultiomeRuns/Run_4/outs/atac_peaks.bed	/projects/ucar-lab/Siddhartha/Covid_19/snATACseq/MultiOme/MultiomeRuns/Run_4/outs/SplitBams_Final/AllBarcodes_OutliersandDoubletRemovedTwice.csv	/projects/ucar-lab/Siddhartha/Covid_19/snATACseq/MultiOme/MultiomeRuns/Run_4/outs/SplitBams_Final/Plots/atac_fragments.tsv.gz
HDv	/projects/ucar-lab/Siddhartha/Covid_19/snATACseq/MultiOme/MultiomeRuns/Run_6/outs/atac_peaks.bed	/projects/ucar-lab/Siddhartha/Covid_19/snATACseq/MultiOme/MultiomeRuns/Run_6/outs/SplitBams_Final/AllBarcodes_OutliersandDoubletRemovedTwice.csv	/projects/ucar-lab/Siddhartha/Covid_19/snATACseq/MultiOme/MultiomeRuns/Run_6/outs/SplitBams_Final/Plots/atac_fragments.tsv.gz
jcov119	/projects/ucar-lab/Siddhartha/Covid_19/snATACseq/MultiOme/MultiomeRuns/Run_9/outs/atac_peaks.bed	/projects/ucar-lab/Siddhartha/Covid_19/snATACseq/MultiOme/MultiomeRuns/Run_9/outs/SplitBams_Final/AllBarcodes_OutliersandDoubletRemovedTwice.csv	/projects/ucar-lab/Siddhartha/Covid_19/snATACseq/MultiOme/MultiomeRuns/Run_9/outs/SplitBams_Final/Plots/atac_fragments.tsv.gz
jcov115	/projects/ucar-lab/Siddhartha/Covid_19/snATACseq/MultiOme/MultiomeRuns/Run_10/outs/atac_peaks.bed	/projects/ucar-lab/Siddhartha/Covid_19/snATACseq/MultiOme/MultiomeRuns/Run_10/outs/SplitBams_Final/AllBarcodes_OutliersandDoubletRemovedTwice.csv	/projects/ucar-lab/Siddhartha/Covid_19/snATACseq/MultiOme/MultiomeRuns/Run_10/outs/SplitBams_Final/Plots/atac_fragments.tsv.gz
Hdu	/projects/ucar-lab/Siddhartha/Covid_19/snATACseq/MultiOme/3rd_multiome/Multiome_Runs/HDu/outs/atac_peaks.bed	/projects/ucar-lab/Siddhartha/Covid_19/snATACseq/MultiOme/3rd_multiome/Multiome_Runs/HDu/outs/HDu/AllBarcodes_OutliersandDoubletRemovedTwice.csv	/projects/ucar-lab/Siddhartha/Covid_19/snATACseq/MultiOme/3rd_multiome/Multiome_Runs/HDu/outs/atac_fragments.tsv.gz
jcov101	/projects/ucar-lab/Siddhartha/Covid_19/snATACseq/MultiOme/3rd_multiome/Multiome_Runs/jcov101/outs/atac_peaks.bed	/projects/ucar-lab/Siddhartha/Covid_19/snATACseq/MultiOme/3rd_multiome/Multiome_Runs/jcov101/outs/jcov101/AllBarcodes_OutliersandDoubletRemovedTwice.csv	/projects/ucar-lab/Siddhartha/Covid_19/snATACseq/MultiOme/3rd_multiome/Multiome_Runs/jcov101/outs/atac_fragments.tsv.gz
jcov110	/projects/ucar-lab/Siddhartha/Covid_19/snATACseq/MultiOme/3rd_multiome/Multiome_Runs/jcov110/outs/atac_peaks.bed	/projects/ucar-lab/Siddhartha/Covid_19/snATACseq/MultiOme/3rd_multiome/Multiome_Runs/jcov110/outs/jcov110/AllBarcodes_OutliersandDoubletRemoved.csv	/projects/ucar-lab/Siddhartha/Covid_19/snATACseq/MultiOme/3rd_multiome/Multiome_Runs/jcov110/outs/atac_fragments.tsv.gz
jcov111	/projects/ucar-lab/Siddhartha/Covid_19/snATACseq/MultiOme/3rd_multiome/Multiome_Runs/jcov111/outs/atac_peaks.bed	/projects/ucar-lab/Siddhartha/Covid_19/snATACseq/MultiOme/3rd_multiome/Multiome_Runs/jcov111/outs/jcov111/AllBarcodes_OutliersandDoubletRemoved.csv	/projects/ucar-lab/Siddhartha/Covid_19/snATACseq/MultiOme/3rd_multiome/Multiome_Runs/jcov111/outs/atac_fragments.tsv.gz
jcov117	/projects/ucar-lab/Siddhartha/Covid_19/snATACseq/MultiOme/3rd_multiome/Multiome_Runs/jcov117/outs/atac_peaks.bed	/projects/ucar-lab/Siddhartha/Covid_19/snATACseq/MultiOme/3rd_multiome/Multiome_Runs/jcov117/outs/jcov117/AllBarcodes_OutliersandDoubletRemovedTwice.csv	/projects/ucar-lab/Siddhartha/Covid_19/snATACseq/MultiOme/3rd_multiome/Multiome_Runs/jcov117/outs/atac_fragments.tsv.gz
jcov124	/projects/ucar-lab/Siddhartha/Covid_19/snATACseq/MultiOme/3rd_multiome/Multiome_Runs/jcov125/outs/atac_peaks.bed	/projects/ucar-lab/Siddhartha/Covid_19/snATACseq/MultiOme/3rd_multiome/Multiome_Runs/jcov125/outs/jcov125/AllBarcodes_OutliersandDoubletRemovedTwice.csv	/projects/ucar-lab/Siddhartha/Covid_19/snATACseq/MultiOme/3rd_multiome/Multiome_Runs/jcov125/outs/atac_fragments.tsv.gz
jcov127	/projects/ucar-lab/Siddhartha/Covid_19/snATACseq/MultiOme/3rd_multiome/Multiome_Runs/jcov127/outs/atac_peaks.bed	/projects/ucar-lab/Siddhartha/Covid_19/snATACseq/MultiOme/3rd_multiome/Multiome_Runs/jcov127/outs/jcov127/AllBarcodes_OutliersandDoubletRemovedTwice.csv	/projects/ucar-lab/Siddhartha/Covid_19/snATACseq/MultiOme/3rd_multiome/Multiome_Runs/jcov127/outs/atac_fragments.tsv.gz
jcov21	/projects/ucar-lab/Siddhartha/Covid_19/snATACseq/MultiOme/3rd_multiome/Multiome_Runs/jcov21/outs/atac_peaks.bed	/projects/ucar-lab/Siddhartha/Covid_19/snATACseq/MultiOme/3rd_multiome/Multiome_Runs/jcov21/outs/jcov21/AllBarcodes_OutliersandDoubletRemovedTwice.csv	/projects/ucar-lab/Siddhartha/Covid_19/snATACseq/MultiOme/3rd_multiome/Multiome_Runs/jcov21/outs/atac_fragments.tsv.gz
jcov42-20	/projects/ucar-lab/Siddhartha/Covid_19/snATACseq/MultiOme/3rd_multiome/Multiome_Runs/jcov42-20/outs/atac_peaks.bed	/projects/ucar-lab/Siddhartha/Covid_19/snATACseq/MultiOme/3rd_multiome/Multiome_Runs/jcov42-20/outs/jcov42-20/AllBarcodes_OutliersandDoubletRemovedTwice.csv	/projects/ucar-lab/Siddhartha/Covid_19/snATACseq/MultiOme/3rd_multiome/Multiome_Runs/jcov42-20/outs/atac_fragments.tsv.gz
jcov42	/projects/ucar-lab/Siddhartha/Covid_19/snATACseq/MultiOme/3rd_multiome/Multiome_Runs/jcov42/outs/atac_peaks.bed	/projects/ucar-lab/Siddhartha/Covid_19/snATACseq/MultiOme/3rd_multiome/Multiome_Runs/jcov42/outs/jcov42/AllBarcodes_OutliersandDoubletRemovedTwice.csv	/projects/ucar-lab/Siddhartha/Covid_19/snATACseq/MultiOme/3rd_multiome/Multiome_Runs/jcov42/outs/atac_fragments.tsv.gz
jcov56-9	/projects/ucar-lab/Siddhartha/Covid_19/snATACseq/MultiOme/3rd_multiome/Multiome_Runs/jcov56-9/outs/atac_peaks.bed	/projects/ucar-lab/Siddhartha/Covid_19/snATACseq/MultiOme/3rd_multiome/Multiome_Runs/jcov56-9/outs/jcov56-9/AllBarcodes_OutliersandDoubletRemovedTwice.csv	/projects/ucar-lab/Siddhartha/Covid_19/snATACseq/MultiOme/3rd_multiome/Multiome_Runs/jcov56-9/outs/atac_fragments.tsv.gz
jcov60-6	/projects/ucar-lab/Siddhartha/Covid_19/snATACseq/MultiOme/3rd_multiome/Multiome_Runs/jcov60-6/outs/atac_peaks.bed	/projects/ucar-lab/Siddhartha/Covid_19/snATACseq/MultiOme/3rd_multiome/Multiome_Runs/jcov60-6/outs/jcov60-6/AllBarcodes_OutliersandDoubletRemovedTwice.csv	/projects/ucar-lab/Siddhartha/Covid_19/snATACseq/MultiOme/3rd_multiome/Multiome_Runs/jcov60-6/outs/atac_fragments.tsv.gz
jcov69-8	/projects/ucar-lab/Siddhartha/Covid_19/snATACseq/MultiOme/3rd_multiome/Multiome_Runs/jcov69-8/outs/atac_peaks.bed	/projects/ucar-lab/Siddhartha/Covid_19/snATACseq/MultiOme/3rd_multiome/Multiome_Runs/jcov69-8/outs/jcov69-8/AllBarcodes_OutliersandDoubletRemovedTwice.csv	/projects/ucar-lab/Siddhartha/Covid_19/snATACseq/MultiOme/3rd_multiome/Multiome_Runs/jcov69-8/outs/atac_fragments.tsv.gz
jcov72-5	/projects/ucar-lab/Siddhartha/Covid_19/snATACseq/MultiOme/3rd_multiome/Multiome_Runs/jcov72-5/outs/atac_peaks.bed	/projects/ucar-lab/Siddhartha/Covid_19/snATACseq/MultiOme/3rd_multiome/Multiome_Runs/jcov72-5/outs/jcov72-5/AllBarcodes_OutliersandDoubletRemoved.csv	/projects/ucar-lab/Siddhartha/Covid_19/snATACseq/MultiOme/3rd_multiome/Multiome_Runs/jcov72-5/outs/atac_fragments.tsv.gz
jcov93	/projects/ucar-lab/Siddhartha/Covid_19/snATACseq/MultiOme/3rd_multiome/Multiome_Runs/jcov93/outs/atac_peaks.bed	/projects/ucar-lab/Siddhartha/Covid_19/snATACseq/MultiOme/3rd_multiome/Multiome_Runs/jcov93/outs/jcov93/AllBarcodes_OutliersandDoubletRemovedTwice.csv	/projects/ucar-lab/Siddhartha/Covid_19/snATACseq/MultiOme/3rd_multiome/Multiome_Runs/jcov93/outs/atac_fragments.tsv.gz
lgtd17	/projects/ucar-lab/Siddhartha/Covid_19/snATACseq/MultiOme/3rd_multiome/Multiome_Runs/lgtd17/outs/atac_peaks.bed	/projects/ucar-lab/Siddhartha/Covid_19/snATACseq/MultiOme/3rd_multiome/Multiome_Runs/lgtd17/outs/lgtd17/AllBarcodes_OutliersandDoubletRemovedTwice.csv	/projects/ucar-lab/Siddhartha/Covid_19/snATACseq/MultiOme/3rd_multiome/Multiome_Runs/lgtd17/outs/atac_fragments.tsv.gz
lgtd18	/projects/ucar-lab/Siddhartha/Covid_19/snATACseq/MultiOme/3rd_multiome/Multiome_Runs/lgtd18/outs/atac_peaks.bed	/projects/ucar-lab/Siddhartha/Covid_19/snATACseq/MultiOme/3rd_multiome/Multiome_Runs/lgtd18/outs/lgtd18/AllBarcodes_OutliersandDoubletRemovedTwice.csv	/projects/ucar-lab/Siddhartha/Covid_19/snATACseq/MultiOme/3rd_multiome/Multiome_Runs/lgtd18/outs/atac_fragments.tsv.gz
HD_AD	/projects/ucar-lab/Siddhartha/Covid_19/snATACseq/MultiOme/2nd_multiome/MultiomeRuns/HD_AD/outs/HD_AD/atac_peaks.bed	/projects/ucar-lab/Siddhartha/Covid_19/snATACseq/MultiOme/2nd_multiome/MultiomeRuns/HD_AD/outs/HD_AD/AllBarcodes_OutliersandDoubletRemovedTwice.csv	/projects/ucar-lab/Siddhartha/Covid_19/snATACseq/MultiOme/2nd_multiome/MultiomeRuns/HD_AD/outs/HD_AD/atac_fragments.tsv.gz
jcov101-2	/projects/ucar-lab/Siddhartha/Covid_19/snATACseq/MultiOme/2nd_multiome/MultiomeRuns/jcov101-2/outs/jcov101-2/atac_peaks.bed	/projects/ucar-lab/Siddhartha/Covid_19/snATACseq/MultiOme/2nd_multiome/MultiomeRuns/jcov101-2/outs/jcov101-2/AllBarcodes_OutliersandDoubletRemovedTwice.csv	/projects/ucar-lab/Siddhartha/Covid_19/snATACseq/MultiOme/2nd_multiome/MultiomeRuns/jcov101-2/outs/jcov101-2/atac_fragments.tsv.gz
jcov122	/projects/ucar-lab/Siddhartha/Covid_19/snATACseq/MultiOme/2nd_multiome/MultiomeRuns/jcov122/outs/jcov122/atac_peaks.bed	/projects/ucar-lab/Siddhartha/Covid_19/snATACseq/MultiOme/2nd_multiome/MultiomeRuns/jcov122/outs/jcov122/AllBarcodes_OutliersandDoubletRemovedTwice.csv	/projects/ucar-lab/Siddhartha/Covid_19/snATACseq/MultiOme/2nd_multiome/MultiomeRuns/jcov122/outs/jcov122/atac_fragments.tsv.gz
jcov49-2	/projects/ucar-lab/Siddhartha/Covid_19/snATACseq/MultiOme/2nd_multiome/MultiomeRuns/jcov49-2/outs/jcov49-2/atac_peaks.bed	/projects/ucar-lab/Siddhartha/Covid_19/snATACseq/MultiOme/2nd_multiome/MultiomeRuns/jcov49-2/outs/jcov49-2/AllBarcodes_OutliersandDoubletRemovedTwice.csv	/projects/ucar-lab/Siddhartha/Covid_19/snATACseq/MultiOme/2nd_multiome/MultiomeRuns/jcov49-2/outs/jcov49-2/atac_fragments.tsv.gz
lgtd8m	/projects/ucar-lab/Siddhartha/Covid_19/snATACseq/MultiOme/2nd_multiome/MultiomeRuns/lgtd8m/outs/lgtd8m/atac_peaks.bed	/projects/ucar-lab/Siddhartha/Covid_19/snATACseq/MultiOme/2nd_multiome/MultiomeRuns/lgtd8m/outs/lgtd8m/AllBarcodes_OutliersandDoubletRemovedTwice.csv	/projects/ucar-lab/Siddhartha/Covid_19/snATACseq/MultiOme/2nd_multiome/MultiomeRuns/lgtd8m/outs/lgtd8m/atac_fragments.tsv.gz
jcov114	/projects/ucar-lab/Siddhartha/Covid_19/snATACseq/MultiOme/2nd_multiome/MultiomeRuns/jcov114/outs/jcov114/atac_peaks.bed	/projects/ucar-lab/Siddhartha/Covid_19/snATACseq/MultiOme/2nd_multiome/MultiomeRuns/jcov114/outs/jcov114/AllBarcodes_OutliersandDoubletRemovedTwice.csv	/projects/ucar-lab/Siddhartha/Covid_19/snATACseq/MultiOme/2nd_multiome/MultiomeRuns/jcov114/outs/jcov114/atac_fragments.tsv.gz
